5 6 13 
AAAAAACCCCCCC
AAAAAACCCCCCD
BBBAAACCCCCDD
BBAAAACCEEDDD
BBBBBACDEEEDD
BBBBBBDDDDDDD